WWWWWWWWWWWWWWWW
WOOOOOOOOOOOOOOW
WOOOOOOOOOOOOOOW
WOOOOOOOOOOOOOOW
WOOOOOOOOOOOOOOW
WOOOOOOOOOOOOOOW
WOOOOOOOOOOOOOOW
WOOOOOOOOOOOOOOW
WOOOOOOOOOOOOOOW
WOOOOOOOOOOOOOOW
WOOOOOOOBOOOOOOW
WWWWWWWWWWWWWWWW