WWWWWWWWWWWWWWWW
WOOOOWOOOOOOOOOW
WOOCOWOOCOOOCOOW
WOOOOWOOOOOOOOOW
WOOOOWOOOOOOOOOW
WOOOOWCOOOOOOOOW
WOOOOWOOOOOOOOOW
WOOOOOOOOOOOOOOW
WOOCOOOOOOOOOOOW
WOOOOOOOOOOOOOOW
WOOOOOOOBOOOOOOW
WWWWWWWWWWWWWWWW