WWWWWWWWWWWWWWWW
WOOOOOOOOOOOOOOW
WOOOOOOOOOOOOOOW
WOOOOOOOOOOOOOOW
WOOOOOOOOOOOOOOW
WOOOOOOOOOOOOOOW
WOOOOOOOOOOOOOOW
WOOOOOOOOOOOOOOW
WOOOOOOOOOOOOOOW
WOOOOOOOOOOOOOOW
WOOOOOOOOOOOOOOW
WWWWWWWWWWWWWWWW