WWWWWWWWWWWWWWWW
WOOOOOOOOOOOOOOW
WOOOOOOOOOOOOOOW
WOOOOOOOOOOOOOOW
WOOOOOOOOOOOOOOW
WOOOOOOOOOOOOOOW
WOOOOOOOOOOOOOOW
WOOOOOOOOOOOOOOW
WOOOOOOOOOOOOOOW
WOOOOOOOOOOOOOOW
WOOOOOOBOOOOOOOW
WWWWWWWWWWWWWWWW