WWWWWWWWWWWWWWWW
WOOOOOOOOOOOOOOW
WOOCOOOOCOOOCOOW
WOOOOOOOOOOOOOOW
WOOOOOOOOOOOOOOW
WOOOOOCOOOOOOOOW
WOOOOOOOOOOOOOOW
WOOOOOOOOOOOOOOW
WOOCOOOOOOOOOOOW
WOOOOOOOOOOOOOOW
WOOOOOOOBOOOOOOW
WWWWWWWWWWWWWWWW